0000000000000000000000000000000000000000
0000000000000000000000000000000000000000
0000000000000000000000000000000000000000
0000000000000000000000000000000000000000
0000000000000000000000000000000000000000
0000000000000000000000000000000000000000
0000000000000000000030000000000000000000
0000000000000000000000000000000000000000
0001000000111110000000000000000000000000
0001000000000000000000000222222222000000
0010100000000000003003000000000000000000
0010000000000011111111110000000000000000
0010000000000000000000000300000000000000
0100000001111111111100022222222200000000
0100000000000000000000000000000000000000
1111111111111000000222222222222000000000
0000000000000000000000000000000222222200
0000000000000000000000000000000000000000
0000000000000000000000000000000000000000
0000000000000000000000000000000000000000
0000000000000000000000000000000000000000
0000000000000000000000000000000000000000
0000000000000000000000000000000000000000
0000000000000000000000000000000000000000
0000000000000000000000000000000000000000
0000000000000000000000000000000000000000
0000000000000000000000000000000000000000
0000000000000000000000000000000000000000
0000000000000000000000000000000000000000
0000000000000000000000000000000000000000

